Abissofobia – medo de abismos, precipícios
Ablepsifobia – medo de ficar cego
Ablutofobia – medo de tomar banho
Amatofobia – medo de poeiras
Batofobia – medo de profundidade
Botanofobia – medo de plantas
Brontofobia – medo de trovões e relâmpagos
Biofobia – medo da vida
Cinofobia – medo de cães
Copofobia – medo da fadiga
Corofobia – medo de dançar
Clinofobia – medo de ir para cama
Diabetofobia – medo de diabetes
Dipsofobia – medo de beber
Disabiliofobia – medo de se vestir na frente de alguém
Dromofobia – medo de cruzar ruas
Eisoptrofobia – medo de espelhos ou de se ver no espelho
Electrofobia – medo de eletricidade
Eleuterofobia – medo da liberdade
Equinofobia – medo de cavalos
Fagofobia – medo de engolir ou de comer
Falacrofobia – medo de tornar-se careca
Farmacofobia – medo de tomar remédios
Fobofobia – medo de fobias
Gamofobia – medo de casar
Gimnofobia – medo de nudez
Glossofobia – medo de falar ou tentar falar em publico
Gnosiofobia – medo do conhecimento
Globofobia – medo de bexigas
Hadefobia – medo do inverno
Hagiofobia – medo de santos ou coisas santas
Hidrofobia – medo de água
Hipsifobia – medo de altura
Iatrofobia – medo de ir ao médico
Ictiofobia – medo de peixe
Iofobia – medo de veneno
Insectofobia – medo de insectos
Katsaridafobia – medo de baratas
Lactofobia – medo de leite
Lilapsofobia – medo de furacões
Limnofobia – medo de lagos
Linonofobia – medo de cordas
Melanofobia – medo de cor preta
Melissofobia – medo de abelhas
Melofobia – medo ou ódio de música
Mictofobia – medo de escuridão
Nelofobia – medo de vidro
Neofarmafobia – medo de medicamentos novos
Neofobia – medo de qualquer coisa nova
Noctifobia – medo da noite
Oenofobia – medo de vinhos
Ofidiofobia – medo de cobras
Oclofobia – medo de multidão
Ocofobia – medo de veículos
Pirofobia – medo do fogo
Quimofobia – medo de ondas
Radiofobia – medo de radiação, raio-x
Somnifobia – medo de dormir
Termofobia – medo de calor
Uranofobia – medo do céu
Verbofobia – medo de palavras
Xenofobia – medo de estrangeiros ou estranhos
Zoofobia – medo de animais